9 15 1 4
. . . . . . . . . # # # . . .
. . . . . . . . . # # # . . .
. . . . . . . . . # # # . . .
# # # # # # . . . # # # # # #
# # # # @ # . . . # # # # G #
# # # # # # . . . # # # # # #
. . . . . . . . . # # # . . .
. . . . . . . . . # # # . . .
. . . . . . . . . # # # . . .
1
{   "switch": "teleport_switch",
    "position": [4,4],
    "blocks_process": 2,
    "point": [[10,1],[10,7]],
    "type": "toggle" }
